>Rosalind_6788
TGTGCCATAGGAGGGCTGCTGATCATTGAGGCATCTCTCGCCCCTTCTACAGCCTAAACA
TCAGGCGCCGCTTCTTGACTACACCTAATTGTATCCCCGGCTCCCAGGAAGCTATGGCAG
TGCTACTTATAGCAGAGTCTCTAGTGACAGTAACCTACGATACGTATTCGGACACTGTTC
GATGCATATTTTGAACTCGAGTTAAACCTCGGCATAGCCCTGGGGAACCTGATCTGCATG
GAAACTTCCATGGGCTTGAATCCCAGCCTTACAGCACATCATGCTCGCTACCAGAGCCTT
AACACCCCATCACCTCATGGACTGCGCATACGTGTGAGCCGTCGTACTTTAAATCCAGGA
CCTAGGTATAGAGATAGAAGGGGACTAGTGATTCGGGTAGGATAGCCGCCGGCGTGCGTA
GGTTTCCGCCCGTCACGATTAAACCGCAGGTGGCCGATACTGGACTCGGGTCGTTAAAGT
GCTGTAGGTGGGGCACCCGCCAAGGTGCAGCCTGTTTGCTCTTACCGGGGAGGTTTAGGT
TCGGATATCCGTATCAATGCCAGACGATTTCTGACGTGATATTGAGTTGGTTCGGTAATG
TTCCGGCCCAGCTGTTGTCCAACTGGCTGTGGAGGTAAACTCGTTAAACTTTCTCCGCCC
TGACGAGTCGGGTGCCTACCGAGTGGCTCTGTCCGGCCAGTGACCGTCATATGAGCACCT
GCCATGGCAACTTCTAGGATGTGGTCATAAAATAAAGCATACTGGTTCGTGATGTGGTAA
TAGCAAATCTAAAAGTAAGAATAGTCTCGGTTATATCTGGGTCGCTTGCACTAGTATTAC
TTCGTTTGTATCAGTCAAGCTTACGATGGTTGGA
>Rosalind_2293
GAGGTAAAGCCGCGAGTGTTGTGGGATGATGAGATAGACAAAGGCCCCTCGTGTCTACTG
TTGCTAAAAGCACGAATCTATGACGATGGCTGCGGTTCACGTTTAGTTGTTTATTTCGTT
CGTAGGCCTAGTGGTAGCTGACGGCGACTGAAACGTTCCAAAGTGGAGTTGGCCCGTTTT
GTCCTGTCTCAGCCCAGGAATGGGGGCGGAACACGCGCTAGCAGGACATCTCCGATCGCG
GCCCGCTTGTTATCTTCACTCGTGGTATCTCTCTGTTAGAACGTATAGACATCGAGGTAT
CAGAATGGCGCAGGGAATCTATAGCCGTAAGCGTTAACCGAACGGAGATGGCTATATGTG
GTGCGCTAACATAGCAAGGGTCGCTATCGGAAGCCCGATAGTGTGGAGTTTCGGCTATTC
TGGAAGGTGCCTAATGATCAAGCGACCCTCGGAGAGAATCTTAGTTGCGTTTCGATGTAG
AAAAAACCCTTAGCCTTATGCCTATCGTGATATCAACTCGGCTAGGGCTCCGCAACCCCG
AGGATACGAGCAAATGCGAAGGTCCAGGTCACCGACTTGGGTCCTTAACAAACTGACTCC
ACCATTCACTTATAGCAAACTCGGGAGGCCTTTTGATATCCAGATGACAGAGTTGTTTCC
AAAGTGTTAATTGTATTGTAGGGGTCCCAGTACAGTGATTAACTAGTTCGGAGGTGATGC
GAGTAACGTAGCTGGTCTTGTGCAGAAAGTGGGACGATTCACTAGTGTGAATGGCCTCAC
TCATTCCATACACTGCCTCGGTTCTAGGATGTTCTACCTACTATGCTCCCGCGTGCTATC
ACAGGAGAGCGGCTCACTCTTAAGCACAGCCGGCAACGCACCTGCCGTT
>Rosalind_9930
AACCGGGGATGTTGACCTGTCGAGCGCTTAAGGTCGGGGGGCGGGTGACATTAAGGGTAG
GCAAGGTCCGCCTACTAGAATTTCGCGTTAGTGGCTTGATGTGGCATACAATTCTCCAAG
CGCAGATTGTAACTTATGCACATCCGCGTGAGGTCAACTAAATAAATTGGCTCCGCAATC
AAATGTACGTGCATCTGAAAAGTAGAAAGCACTAAGCATGCAGCGCCTGTAAAAACGACT
TGCCAGAAATCGTTGTGCTCTCACTTATACGTGTGCGGCCACGCTGCTTGGGCAGTACAT
GCAAAGCGACAACGCTACTCGTGAACCAGAACGTAAAACTCAATTTGGTGTCCTGAGTCC
CATTGCCTGTGAGTGCTCATGTAACCCAAAGCGCCCAGAGACGTCAGGAGTTGTTTCCAC
CAGCTGGACGAATGTTAGCTAACGAGAGCTAGCTGTGTGATTGGAAGGTGCGTAGGTAAG
CGCTTAATCAATCGTTAAGGGTAATAGAATTGGTGCTAACGCGCGTTCCGCTGTGACAAC
CGTTATGACACTGTTGACTTCCGGAATCTGACTTCTTTTTAGGTCCTGTGTGCGATGAAG
TTGAGGAGACAGACATTCCAGTTTTCTATCAGCCGCTTCTTCTAGCACCGCGATATACCG
GGTAAAATCCGCGTGCATGCTACCAACGCCGCGCATACGCTGCGTCCGCGTTTTGCGATA
CGAGCGTTGGGATACGCAAGACCTAACGCTTTCGAGGGGGGCCTCGTCCGGAGGTATAAT
CTCCTCAGCGGGGGAGCCTGCCTATCATGAGAGGTCTATGCGTGTAGGCT
>Rosalind_6143
CCACCGGCTGCTAGAACGGGAGATATGTCGCTCATGAGTCTCTCCGATCGAAAATAGAGA
CTGATACGGGAACTTGCTTTCGTGAAACGTTCGCATAAGGAATAAGGCCCAACGGCAGCT
CGCGGTGCTGTACTATGAGCTCTCGATTACCATAAGAATAAAGTTACAGCGAGTTGCGGG
GGGGACCCCAACAAGTTATACATCAATCCTAACACCTGGTTCCGCTCGCATTAGCTAATA
GTAGTCCTCACTAACATACGACTCGACGACACACTGTCCTCACGCTAGCGACCTAGCCCG
ATTGATGCATGTTGGGTTTACTCCAAAATTAAGTTCAGGCGGATGTAGCCCGCAAAGTGA
AGTAATGCCCGTTACCTTACTAGTCATGGCAATAGGACAATGGTATCCCCGATCTCCGGA
AAACAATACACGCTAGAACGCTCCCTGGCGTCCCGAAGGAGTGCAGGTGCGGTCGTGAAA
TTCTTGCTCGCGTGCAAGTACGCGAAGGGCGGACCTCCCAGAGTGTGAGAAATGAACGCG
GATCCGGGTATTTAATACTATATAGTACGGACCATGGCCGAGAGCACAGAAATAAGATGT
AGGCGACGTTTCAGTTACTGAAAGCAATGTATTGACGCTGATTGACAAGAAGGGACCTTC
GGGCTGGCGCATTGTGTTGATGGCGCGTTTGTACCTACCGAAGGTGTGATATCTTCATGC
TCACCAAGGGAGGGTTCATTCATCGATACAGCTAAGCCCTGGCGTTCTTCGAATATAAAC
GCGCCGTGCCCGAGTCCGTTTGGGATCTTCGCCCCGTTCCGTTAGAATACGCAGGACACC
TTAATGTCCTTTTTATGACCTAATTGATCACTATTC
>Rosalind_5073
AATTCAGCCCTTTCCGGCGGAACGGCCCACAAACTGCAGTCTTGGACCGACGTAATCCCA
GAAGGCAGTGTAATGCCCCTTGCAGTCTATGTTTGTTGACTACAGAATCAACCAGGCTTA
AGCAGAGGCAGGTTGCATTCACGACGACAAGTCGACGCGTTTCCCAGTACATAGTCCGAC
GGTGACCTGCCTAGCAGGCCTGGCAGAAGAAATCAGGTCGGCCCGACTTGACCGGACCTG
CCCTAAGGATTCACTACACTCGGCAACTTTGCCTTCACCATAGGCCCCAGAGGATTTCGT
AGGTAGGTCAGATTCCGGTATTGTGGGCGATGACCGCGGCCGAATGTAGTTAATAATTGT
CGATAACGTCAAATTGACCGATCAAGAATCGCTCTACACGCTAACAAAAGAGGGTTCCGA
GATAGCCATTGGTCTATCATGAGCGTATCTAATGGCGCACGCCTCGCATCGCCCGCTTAA
AGCTCTTAAATCGTAGGAGCAGTTACGAGTGTGCAGCTATATGTGCTTAAGACGTACTCG
GGAATATCCTTCCCGCGTTATGGCTGTGGGGGTTCAGACGAGTATTCCTAGCGAGGACGG
CATAGGCTGAATTAGATAAAACCCGGTGTATTAATTCTCACTATGTCGCAACAGCGCTCA
AACGTTAAGGAATGCTCTAGGCCTAACAATGCTGGGCATGTTACCATACGGCAGGTTCGG
CCATGATTAACCATACCTTCCGGGTGACAAAGACTAACGATCCTCCACTGCTTGGGAGGT
GCATATGCGGCGGGAGACCAGGTCGGTACAATAGAGCGCAGGCGCGGAATAGTCTGAGGG
TGCAGCTATAGGATTGTAGAGCGGTTCGCTCTGTATTGTGAGCCCTTTACTCTTCCTCGA
TACCGCGCTACTATTGTCTGATAGCTCTCTCCAGAGTGTCTCGAGAAGACG
>Rosalind_8168
ACCACGGCGCTCTTGCATAATTTCATCTGACTTACGCCCACTTTTATCCTTTAATTTTAG
AGATTGGCCGTGCGGGAGGTAGTGGTTGGACAATGTGCACCAGTGGACCTTGGAGAAACT
AAAGTTAAGTTCCCCCATCCGTTCCACTAGGTCTGGGTTCGTGAAATCTCCCGTATACAC
ACCGTCGACATGCTAGCATTAATAGTTTGGATAGGGGTGCAAAGTGTTAGCACCGTTCTG
ATATTTACAGGAGTGCAAGTGTGACGAATCCATCTACGAGGGTCACGTTAAAAGTCAGTG
TCAGGGACAGTGGCCTGAGTAGTTCTGTCGACTGGCAACTTGGTAATTCCCAATCATGTC
CGGTCGCGGATACCTACTTCCATCCTTTACTTACTTAGTCCTTTCCACTTCAAACGGAGT
GGACTTGAGAAAGCAAGCTTTTATTTCCTTCTGGCTGCGACTACAGTTTGGTTTAAGGGT
ACTCTGACCTTCGACGCCGTTATGCTATTGCCCCATACCAACTATCTACACAGACTTACT
CAACTTTCGCGCAAAACTCTCCTTTAGCCGAGTTGAGGCACCGGTCAGAGAGTGGTAAAG
GTGTGGATCGGGCCGCCGTGTCGTCATCGCGCTAACGTGTAATTAGGGCTGGATCCGGAC
CGCTCCCCGGTGTATGACTCGGTATAATACAGTCGATCTTTATCGTGTACATTAACCCAC
TCAGGTTAGACGGTATTTCATCGGAACAGATAAGACGCCTGCAGTGGTTGGGGGAGTAGC
CTGCGTAACCCGTTTGGCCCGTAGCTACGGCTCCGTAATTAAAACCGTCCAGAGCGTGAA
CCCGTGCATAGATCTCACCCCTGTTACTGCGAGCACCGGGTGACTATGTTGATCCTCGGA
TATCCAAATCCTAACCCGATACCTCTAAACTGCGATTCAATTAAACAAACGGTTCGACAC
TACAGG
